大雪山=Đại Tuyết sơn
维塔斯=Vitas
冥龙锁天阵=Minh Long Tỏa Thiên Trận
纪宁=Kỷ Ninh
紫府=Tử Phủ
神魔=Thần Ma
纪氏=Kỷ thị
万象=Vạn Tượng
天仙=Thiên Tiên
木子朔=Mộc Tử Sóc
子朔=Tử Sóc
黑白学宫=Hắc Bạch Học Cung
紫府修士=Tử Phủ Tu Sĩ
九莲=Cửu Liên
少炎农=Thiếu Viêm Nông
翼蛇=Dực Xà
百微=Bách Vi
安澶=An Thiền
雪龙=Tuyết Long
纪九火=Kỷ Cửu Hỏa
大夏=Đại Hạ
雪龙山=Tuyết Long Sơn
万象真人=Vạn Tượng Chân Nhân
应龙卫=Ứng Long Vệ
先天=Tiên Thiên
元神道人=Nguyên Thần Đạo Nhân
应龙=Ứng Long
元神=Nguyên Thần
仙缘大会=Tiên Duyên Đại Hội
白水泽=Bạch Thủy Trạch
少炎氏=Thiếu Viêm thị
黄毛大熊=hoàng mao đại hùng
燕山=Yến Sơn
小千剑阵=Tiểu Thiên Kiếm Trận
邋遢=Lạp Tháp
道祖=Đạo Tổ
邋遢真人=Lạp Tháp Chân Nhân
夏芒=Hạ Mang
尉迟雪=Uất Trì Tuyết
水火莲花=Thủy Hỏa Liên Hoa
空青蛇=Không Thanh Xà
翼蛇湖=Dực Xà Hồ
殿才=Điện Tài
洞子启=Động Tử Khải
许离=Hứa Ly
许离真人=Hứa Ly Chân Nhân
殿才仙人=Điện Tài Tiên Nhân
安澶郡=An Thiền quận
相柳方=Tương Liễu Phương
北冥剑=Bắc Minh kiếm
天宝山=Thiên Bảo Sơn
赤明九天=Xích Minh Cửu Thiên
赤明九天图=Xích Minh Cửu Thiên Đồ
铁木占=Thiết Mộc Chiêm
巫江=Vu Giang
三尺剑=Tam Xích Kiếm
摘星手=Trích Tinh Thủ
雎华=Sư Hoa
雎华仙人=Sư Hoa Tiên Nhân
木传真人=Mộc Truyền Chân Nhân
木传=Mộc Truyền
大夏王都=Đại Hạ vương đô
风翼遁法=Phong Dực Độn Pháp
风翼=Phong Dực
惜月郡主=Tích Nguyệt quận chúa
纯阳真仙=Thuần Dương Chân Tiên
延王=Duyên Vương
夏芒紫山=Hạ Mang Tử Sơn
沧江=Thương Giang
北山狐=Bắc Sơn Hồ
少炎=Thiếu Viêm
少炎公子=Thiếu Viêm công tử
雪羽道人=Tuyết Vũ Đạo Nhân
苍梧鹫=Thương Ngô Thứu
玄机老祖=Huyền Ky Lão Tổ
龙鲸大妖=Long Kình Đại Yêu
封禁大阵=Phong Cấm Đại Trận
纪留真=Kỷ Lưu Chân
明月山=Minh Nguyệt Sơn
浮云仙人=Phù Vân Tiên Nhân
方寸山=Phương Thốn Sơn
明月山水图=Minh Nguyệt Sơn Thủy Đồ
沧江真人=Thương Giang Chân Nhân
纪宁公子=Kỷ Ninh công tử
论道殿=Luận Đạo Điện
北山氏=Bắc Sơn thị
穷奇=Cùng Kỳ
安澶侯=An Thiền Hầu
黑石真人=Hắc Thạch Chân Nhân
火翼妖王=Hỏa Dực Yêu Vương
三寿=Tam Thọ
道之域境=Đạo Chi Vực Cảnh
北山黑虎=Bắc Sơn Hắc Hổ
大荒泽=Đại Hoang Trạch
狱山大荒泽=Ngục Sơn Đại Hoang Trạch
唐天=Đường Thiên
兵=Binh
顾雪=Cố Tuyết
剑齿虎=Kiếm Xỉ Hổ
白鹤漩涡=Vòng Xoáy Bạch Hạc
鬼爪=Quỷ Trảo
大燕=Đại Yên
聂隐=Nhiếp Ẩn
金玉珍=Kim Ngọc Trân
魔心醉=Ma Tâm Túy
无亘府=Vô Tuyên Phủ
一爪=Nhất Trảo
二爪=Nhị Trảo
三爪=Tam Trảo
寒=Hàn
洪统领=Hồng Thống Lĩnh
雕绝=Điêu Tuyệt
幽虹府=U Hồng Phủ
血影天龙杀=Huyết Ảnh Thiên Long Sát
星辰岛上的人=trên Tinh Thần Đảo này
天穹水晶=Thiên Khung Thủy Tinh
李芝=Lý Chi
丹尊=Đan Tôn
大紫薇丹=Đại Tử Vi Đan
菩提丹=Bồ Đề Đan
化海秘术=Hóa Hải Bí Thuật
鹤老=Hạc Lão
碎星=Toái Tinh
南帝尊=Nam Đế Tôn
轮回者=Luân Hồi Giả
天猿一族=Thiên Viên Nhất Tộc
涂博凡=Đồ Bác Phàm
司空燕=Ti Không Yến
司空来=Ti Không Lai
龙心丹=Long Tâm Đan
混沌晶=Hỗn Độn Tinh
白学长=Bạch Học Trường
白梵=Bạch Phạm
谷草=Cốc Thảo
血修罗一族=Huyết Tu La Nhất Tộc
御兽宗=Ngự Thú Tông
九剑道尊=Cửu Kiếm Đạo Tôn
青山宗=Thanh Sơn Tông
吴英杰=Ngô Anh Kiệt
万法池=Vạn Pháp Trì
方青山=Phương Thanh Sơn
林璃=Lâm Ly
冬鸣天尊=Đông Minh Thiên Tôn
白雪=Bạch Tuyết
紫千华=Tử Thiên Hoa
剑元波=Kiếm Nguyên Ba
旭日=Húc Nhật
钟天尊=Chung Thiên Tôn
啸鸣天尊=Khiếu Minh Thiên Tôn
龙符师=Long Phù Sư
阮修年=Nguyễn Tu Niên
赵日卓=Triệu Nhật Trác
煞珠=Sát Châu
石林=Thạch Lâm
龙真=Long Chân
楚三秋=Sở Tam Thu
段金鸿=Đoạn Kim Hồng
叶坤=Diệp Khôn
花玉娇=Hoa Ngọc Kiều
林鹤=Lâm Hạc
死海=Tử Hải
四海=Tứ Hải
丙天落=Bính Thiên Lạc
刁罡=Điêu Cương
易天尊=Dịch Thiên Tôn
曲羊=Khúc Dương
太清殿=Thái Thanh Điện
呼喇=Hô Lạt
天哭崖=Thiên Khốc Nhai
武中无相=Vũ Trung Vô Tướng
风千羽=Phong Thiên Vũ
东方鹤=Đông Phương Hạc
易武阳=Dịch Vũ Dương
聚宝阁=Tụ Bảo Các
张若瑶=Trương Nhược Dao
墨阳赤鸦=Mặc Dương Xích Nha
丹心宫=Đan Tâm Cung
雾老=Vụ Lão
百兽山=Bách Thú Sơn
暗天尊=Ám Thiên Tôn
界尊=Giới Tôn
碧焰流沙=Bích Diễm Lưu Sa
帝厌=Đế Yếm
金斧=Kim Phủ
流沙领域=Lưu Sa Lĩnh Vực
万古至尊=Vạn Cổ Chí Tôn
逆天第四步=Nghịch Thiên Đệ Tứ Bộ
天幻王=Thiên Huyễn Vương
天幻=Thiên Huyễn
江纯=Giang Thuần
灭情九斩=Diệt Tình Cửu Trảm
斩灭=Trảm Diệt
陈牛=Trần Ngưu
河洛神象=Hà Lạc Thần Tượng
天皇杀=Thiên Hoàng Sát
重皇剑=Trọng Hoàng Kiếm
翟炎=Địch Viêm
张降=Trương Hàng
天衍大陆=Thiên Diễn Đại Lục
潘诛=Phan Tru
空明=Không Minh
猿天尊=Viên Thiên Tôn
灵罗宫=Linh La Cung
子虚宫=Tử Hư Cung
李大嘴=Lý Đại Chủy
李三=Lý Tam
玄梦=Huyền Mộng
在天玄七宗=Tại Thiên Huyền Thất Tông
文不二=Văn Bất Nhị
肖林=Tiếu Lâm
缥缈身法=Phiếu Miểu Thân Pháp
如梦院=Như Mộng Viện
腾龙殿=Đằng Long Điện
赤昆=Xích Côn
万东阳=Vạn Đông Dương
叶九云=Diệp Cửu Vân
九煞惊神枪=Cửu Sát Kinh Thần Thương
裘师伯=Cừu Sư Bá
蒙天发=Mông Thiên Phát
卫劲=Vệ Kính
幽蓝晶焰=U Lam Tinh Diễm
符器师=Phù Khí Sư
墨绿晶焰=Mặc Lục Tinh Diễm
虎千魄=Hổ Thiên Phách
霍东来=Hoắc Đông Lai
九剑宗=Cửu Kiếm Tông
谢晚风=Tạ Vãn Phong
小霜=Tiểu Sương
聂伟华=Niếp Vĩ Hoa
疾风百劲=Tật Phong Bách Kính
寸心万劲=Thốn Tâm Vạn Kình
月佛=Nguyệt Phật
落日惊雷=Lạc Nhật Kinh Lôi
暴击千重破=Bạo Kích Thiên Trọng Phá
七绝连环杀=Thất Tuyệt Liên Hoàn Sát
紫雪夺命手=Tử Tuyết Đoạt Mệnh Thủ
石塔=Thạch Tháp
王四强=Vương Tứ Cường
夜枭秦狂=Dạ Kiêu Tần Cuồng
秦狂=Tần Cuồng
飞禽宗=Phi Cầm Tông
铁皮=Thiết Bì
百花教=Bách Hoa Giáo
木云武=Mộc Vân Vũ
云天尊=Vân Thiên Tôn
霸天=Phách Thiên
凉不凡=Lương Bất Phàm
凉秋=Lương Thu
碎花残梦=Toái Hoa Tàn Mộng
丹心=Đan Tâm
龙须=Long Tu
舒战宏=Thư Chiến Hoành
剑云翔=Kiếm Vân Tường
剑楚衣=Kiếm Sở Y
千草宗=Thiên Thảo Tông
黑丝蛇=Hắc Ti Xà
三重浪=Tam Trọng Lãng
天辰王=Thiên Thần Vương
墨王=Mặc Vương
东龙王=Đông Long Vương
古墓王=Cổ Mộ Vương
陀螺掌=Đà Loa Chưởng
九夕=Cửu Tịch
灵武之初=Linh Vũ Chi Sơ
青雕灵印=Thanh Điêu Linh Ấn
青云国=Thanh Vân Quốc
曙光=Thự Quang
屠神=Đồ Thần
王胜=Vương Thắng
墨春蕾=Mặc Xuân Lôi
李成玉=Lý Thành Ngọc
幽虹=U Hồng
斧一=Phủ Nhất
五彩金兰=Ngũ Thải Kim Lan
耿秋明=Cảnh Thu Minh
肖如意=Tiếu Như Ý
楼沧海=Lâu Thương Hải
火神傀=Hỏa Thần Khôi
问天楼=Vấn Thiên Lâu
下天门=Hạ Thiên Môn
青叶泪痕剑=Thanh Diệp Lệ Ngân Kiếm
孤心=Cô Tâm
邬圣者=Ổ Thánh Giả
天象=Thiên Tượng
神象之牙=Thần Tượng Chi Nha
六, 道, 轮, 回=Lục, Đạo, Luân, Hồi
陆乌王=Lục Ô Vương
仓木王=Thương Mộc Vương
八门遁甲=Bát Môn Độn Giáp
仓木=Thương Mộc
章华=Chương Hoa
铁冠=Thiết Quan
盖余国=Cái Dư quốc
盖余=Cái Dư
玄蛇妖帝=Huyền Xà Yêu Đế
擎天帝君=Kình Thiên Đế Quân
灵角妖帝=Linh Giác Yêu Đế
祸斗妖帝=Họa Đấu Yêu Đế
灵角=Linh Giác
祸斗=Họa Đấu
苍=Thương
青炎帝君=Thanh Viêm Đế Quân
七宿龙帝=Thất Túc Long Đế
太阿山=Thái A Sơn
紫澜妖王=Tử Lan Yêu Vương
紫澜=Tử Lan
钩蛇妖帝=Câu Xà Yêu Đế
钩蛇=Câu Xà
寒蝉=Hàn Thiền
石夷=Thạch Di
玄蜂=Huyền Phong
火鼠妖帝=Hỏa Thử Yêu Đế
风豺=Phong Sài
荒海=Hoang Hải
花界=Hoa Giới
昼夜之地=Trú Dạ chi địa
狼先锋=Lang Tiên Phong
李玄宗=Lý Huyền Tông
玄法戒=Huyền Pháp Giới
地鲲王=Địa Côn Vương
月巫王=Nguyệt Vu Vương
月巫=Nguyệt Vu
青炎=Thanh Viêm
七宿=Thất Túc
角宿=Giác Túc
心宿=Tâm Túc
剑界=Kiếm Giới
血猿=Huyết Viên
袁安=Viên An
马猴=Mã Hầu
袁慈=Viên Từ
马啸=Mã Khiếu
赤尻=Xích Khào
马 喧=Mã Huyên
石猴=Thạch Hầu
猕猴=Mi Hầu
灵明=Linh Minh
六耳=Lục Nhĩ
通臂=Thông Tí
赤海猴王=Xích Hải Hầu Vương
赤海=Xích Hải
斗战图录=Đấu Chiến Đồ Lục
玄参=Huyền Tham
轸宿=Chẩn Túc
胃=Vị
毕=Tất
参宿=Tham Túc
地狱十门=Địa Ngục Thập Môn
马德猴王=Mã Đức Hầu Vương
钧天大帝=Quân Thiên Đại Đế
钧天的大帝=Quân Thiên Đại Đế
斗战前辈=Đấu Chiến tiền bối
斗战大帝=Đấu Chiến Đại Đế
龙烽=Long Phong
灿龙王=Xán Long Vương
尸神王者=Thi Thần Vương Giả
尸神=Thi Thần
灼日龙帝=Chước Nhật Long Đế
冰霜龙帝=Băng Sương Long Đế
烁龙王=Thước Long Vương
厌胜诅咒=Yếm Thắng Trớ Chú
蹈海=Đạo Hải
灼日=Chước Nhật
钟岳城=Chung Nhạc Thành
花语=Hoa Ngữ
花落=Hoa Lạc
飞沙=Phi Sa
石阙=Thạch Khuyết
黑沙妖王=Hắc Sa Yêu Vương
毒界=Độc Giới
白骨=Bạch Cốt
无生=Vô Sinh
虚空夜叉=Hư Không Dạ Xoa
谢煜=Tạ Dục
冲虚宫=Trùng Hư Cung
无虚剑=Vô Hư Kiếm
风火观=Phong Hỏa Quan
葬天=Táng Thiên
夜天星=Dạ Thiên Tinh
石帝=Thạch Đế
皓天=Hạo Thiên
苍天=Thương Thiên
旻天=Mân Thiên
钧天=Quân Thiên
朱天=Chu Thiên
阳天=Dương Thiên
皓天之主=Hạo Thiên chi chủ
婆雅=Bà Nhã
钧天之主=Quân Thiên chi chủ
阳天之主=Dương Thiên chi chủ
朱天之主=Chu Thiên chi chủ
苍天之主=Thương Thiên chi chủ
玄天之主=Huyền Thiên chi chủ
炎天之主=Viêm Thiên chi chủ
幽天之主=U Thiên chi chủ
旻天之主=Mân Thiên chi chủ
至暗=Chí Ám
宇宙职业选手=Vũ Trụ Chức Nghiệp Tuyển Thủ
蓝星=Lam Tinh
杨青烁=Dương Thanh Thước
烁=Thước
体育局=Cục Thể thao
把块=Bả khối
黎渺渺=Lê Miểu Miểu
渺渺=Miểu Miểu
抱犊山=Bão Độc Sơn
凝道境=Ngưng Đạo cảnh
功德金莲=Công Đức Kim Liên
灭世黑莲=Diệt Thế Hắc Liên
世界变=Thế Giới biến
血肉变=Huyết Nhục biến
悟道境=Ngộ Đạo cảnh
御道境=Ngự Đạo cảnh
道尊=Đạo Tôn
幽冥剑=U Minh kiếm
个徐瑞=Cá Từ Thụy
徐瑞=Từ Thụy
孟石=Mạnh Thạch
陈千禾=Trần Thiên Hòa
混沌道=Hỗn Độn đạo
千禾=Thiên Hòa
华盖州=Hoa Cái Châu
玄鼠门=Huyền Thử môn
莲生指=Liên Sinh chỉ
华盖洲=Hoa Cái Châu
豺狼虎豹=Sài, Lang, Hổ, Báo
悬羊峰=Huyền Dương Phong
玄羊岭=Huyền Dương Lĩnh
玄羊=Huyền Dương
豺族=Sài tộc
烛照=Chúc Chiếu
幽荧=U Huỳnh
二等势力=Nhị đẳng thế lực
巨灵谷=Cự Linh Cốc
玄鸟林=Huyền Điểu Lâm
冰霜雪=Băng Sương Tuyết
冰霜雪原=Băng Sương Tuyết Nguyên
大道尊=Đại Đạo Tôn
林蒙=Lâm Mông
至尊=Chí Tôn
五毒宫=Ngũ Độc Cung
杨漠=Dương Mạc
至天尊=Chí Thiên Tôn
无上天尊=Vô Thượng Thiên Tôn
采薇=Thải Vi
李浑=Lý Hồn
千蛛林=Thiên Chu Lâm
毒蝎岭=Độc Hạt Lĩnh
千足=Thiên Túc
至道尊=Chí Đạo Tôn
天蝎宫主=Thiên Hạt Cung chủ
天蟾宫主=Thiên Thiềm Cung chủ
邪灭至尊=Tà Diệt Chí Tôn
如梦令=Như Mộng lệnh
师尊=Sư tôn
烽伯=Phong Bá
天尊=Thiên Tôn
天尊盛会=Thiên Tôn Thịnh Hội
圣地=Thánh Địa
天织=Thiên Chức
宁炎道尊=Ninh Viêm Đạo Tôn
朱雀令=Chu Tước lệnh
朱凉=Chu Lương
符苍天=Phù Thương Thiên
天罚圣地=Thiên Phạt Thánh Địa
谢麟=Tạ Lân
万灵古燚=Vạn Linh Cổ Diệc
六丁山脉=Lục Đinh Sơn mạch
幽冥鬼火=U Minh Quỷ Hỏa
子午钺=Tử Ngọ Việt
烈灵地=Liệt Linh Địa
烟灵地=Yên Linh Địa
燃灵地=Nhiên Linh Địa
庞之烟=Bàng Chi Yên
九燃=Cửu Nhiên
玄牝山=Huyền Tẫn sơn
功德莲台=Công Đức Liên Thai
华若=Hoa Nhược
槐安=Hòe An
姑瑶别院=Cô Dao Biệt Viện
姑瑶圣人=Cô Dao Thánh Nhân
莲峰=Liên Phong
寂灭圣地=Tịch Diệt Thánh Địa
垂天=Thùy Thiên
青雍=Thanh Ung
九影=Cửu Ảnh
生命圣地=Sinh Mệnh Thánh Địa
主上=Chủ thượng
木麒=Mộc Kỳ
雨水大道=Vũ Thủy Đại Đạo
黑色莲峰=Hắc Sắc Liên Phong
人族=Nhân tộc
梅梁至尊=Mai Lương Chí Tôn
山长=Sơn trưởng
苏蝶=Tô Điệp
遁去=Độn Khứ
人族至尊=Nhân Tộc Chí Tôn
江潮至尊=Giang Triều Chí Tôn
生命之城=Sinh Mệnh Chi Thành
生命之石=Sinh Mệnh Chi Thạch
潮汐大道=Triều Tịch Đại Đạo
古沙至尊=Cổ Sa Chí Tôn
古沙=Cổ Sa
风之大道=Phong Chi Đại Đạo
碧落圣女=Bích Lạc Thánh Nữ
江潮=Giang Triều
姑瑶=Cô Dao
寂灭圣主=Tịch Diệt Thánh Chủ
天罚圣主=Thiên Phạt Thánh Chủ
土之大道=Thổ chi Đại Đạo
黄沙大道=Hoàng Sa Đại Đạo
后土大道=Hậu Thổ Đại Đạo
重力大道=Trọng Lực Đại Đạo
地裂大道=Địa Liệt Đại Đạo
玄牝圣人=Huyền Tẫn Thánh Nhân
生命圣主=Sinh Mệnh Thánh Chủ
玄牝=Huyền Tẫn
人书=Nhân thư
心神=tâm thần
量劫=Lượng Kiếp
太始元灵=Thái Thủy Nguyên Linh
阴之圣灵=Âm Chi Thánh Linh
阳之圣灵=Dương Chi Thánh Linh
造化圣灵=Tạo Hóa Thánh Linh
谷神=Cốc Thần
生命圣王=Sinh Mệnh Thánh Vương
弑圣枪=Thí Thánh Thương
红尘=hồng trần
阴之大道=Âm chi đại đạo
阳之大道=Dương chi đại đạo
风之大圣=Phong Chi Đại Thánh
烟姬=Yên Cơ
风之圣人=Phong Chi Thánh Nhân
天罚剑=Thiên Phạt kiếm
寂灭=Tịch Diệt
天罚=Thiên Phạt
阴阳元灵=Âm Dương Nguyên Linh
时空元灵=Thì Không Nguyên Linh
寂灭元灵=Tịch Diệt Nguyên Linh
三书=Tam Thư
太始=Thái Thủy
轮回圣王=Luân Hồi Thánh Vương
地狱道=Địa Ngục Đạo
紫土=Tử Thổ
陈飞源=Trần Phi Nguyên
柏大师=Bách đại sư
雷队=Lôi Đội
十字=Thập Tự
拾荒者=Thập Hoang giả
离途教=Ly Đồ Giáo
铁签=Thiết Thiêm
南凰洲=Nam Hoàng châu
七血瞳=Thất Huyết Đồng
骨刀=Cốt Đao
蜈血=Ngô Huyết
柏少=Bách Thiếu
柏云东=Bách Vân Đông
李若琳=Lý Nhược Lâm
鸾牙=Loan Nha
三撇胡=Tam Phiết Hồ
松涛城=Tùng Đào thành
夜鸠=Dạ Cưu
张世元=Trương Thế Nguyên
营主=Doanh chủ
桃红=Đào Hồng
鹿角城=Lộc Giác thành
云文=Vân Văn
金刚宗老祖=Kim Cương tông lão tổ
清尘丹=Thanh Trần Đan
真理山脉=Chân Lý sơn mạch
凰禁=Hoàng Cấm
望古大陆=Vọng Cổ đại lục
夜王=Dạ Vương
李子梅=Lý Tử Mai
阵翰=Trận Hàn
赵春刚=Triệu Xuân Cương
徐小慧=Từ Tiểu Tuệ
捕凶司=Bộ Hung Ty
轮=Luân
舟=Chu
船=Thuyền
舰=Hạm
大翼=Đại Dực
化海经=Hóa Hải Kinh
魁=Khôi
魈=Tiêu (ma núi)
徐艳红=Từ Diễm Hồng
地部=Địa Bộ
第九=Đệ Cửu
副司长=Phó Ti Trường
运输司=Vận Thâu Ti
飞翅鱼=Phi Sí Ngư
玄部=Huyền Bộ
青云子=Thanh Vân Tử
板泉路=Bản Tuyền Lộ
白丹=Bạch Đan
黑丹=Hắc Đan
蝶骨花=Điệp Cốt Hoa
金翅叶=Kim Sí Diệp
玲珑枝=Linh Lung Chi
金钮草=Kim Nữu Thảo
凝灵叶=Ngưng Linh Diệp
白根背=Bạch Căn Bối
犀火花=Tê Hỏa Hoa
腐云泥=Hủ Vân Nê
黑瑰刺=Hắc Côi Thứ
黄岩=Hoàng Nham
鬼欲鲎=Quỷ Dục Hấu
人鱼族=Nhân Ngư tộc
鼠道人=Thử đạo nhân
赵中恒=Triệu Trung Hằng
调度司=Điều hành Ty
丁霄海=Đinh Tiêu Hải
引水司=Hoa tiêu Ty
李执事=Lý chấp sự
调度=Điều hành
引水=Hoa tiêu
飞凤舞=Phi Phượng Vũ
游灵子=Du Linh Tử
风行兽=Phong Hành thú
海鬼=Hải Quỷ
